Stage 1
#####
#OoP#
#####
=
Stage 2
  #######
###  O  ###
#    o    #
# Oo P oO #
###  o  ###
 #   O  # 
 ########
=
Stage 3
  #######
###P    ###
#     #    #
#    o0o  #
###  O    ###
 #    O  ## 
 ########
=
Stage 4
##########
#OO       ###
#         ###
# P   #   ###
#   ooo   ##
##    O####
 #      ### 
 ########
=
Stage 5
#############
#          ####
# P        ####
#     #O O##
#   ooo   ##
###    O ####
 #     #### 
 ########